###############################
#p F *2       *  ** * *      *#
# # # # #*# # #*# # # # # #*# #
#    S * *** **      *    **  #
# #B# # # # #1# #b#1# # # # #*#
#          *     **      *  **#
# # #*# # # # # #*#*#*#*# # # #
#   *        *   * *x* *      #
# # # # #*# # # # # # #*# #*# #
#   ****         *1           #
# # # # # # # # # #*# # # # #*#
#  ** *   *    2              #
###############################