##############################
#################1111111* s b#
##       *   222#       *1 f #
##*###### #######       # bs2#
##2###### #######***    # 221#
##x###### ####     *    # 1 s#
#########*####  p  #****######
# 2  #       #     #    #s 2 #
# s  #       #######    # b 1#
# s b#          *       #  f #
# f 2*          *       * 2 b#
#   b*11 1 1 1 1*1111111*  2 #
##############################

