###############################
#p   S* **    *   2           #
# # # #*# # # # # # # # # # # #
#*     *B * *  *   * ** 3 *   #
# # # # # #*# # # # # # #*# # #
#*   *s*    F** * x **        #
# # # # # # # # # # # # # #*# #
#    *     *        *    **  3#
# #*# # #*#*#*#*# # #1# # #*# #
#        *   *2*    *   *     #
#*# # # # # # # # # # #*# # #*#
# *    * **    ** ***     1   #
###############################